the bear|l'orso|animals
the beaver|il castoro|animals
the cat|il gatto|animals
the chimpanzee|lo scimpanz√©|animals
the deer|il cervo|animals
the dog|il cane|animals
the elephant|l'elefante|animals
the fish|il pesce|animals
the fox|la volpe|animals
the goat|la capra|animals
the gorilla|il gorilla|animals
the hippopotamus|l'ippopotamo|animals
the horse|il cavallo|animals
the hyena|la iena|animals
the kangaroo|il canguro|animals
the kitten|il gattino|animals
the leopard|il leopardo|animals
the llama|il lama|animals
the monkey|la scimmia|animals
the mouse|il topo|animals
the panda|il panda|animals
the penguin|il pinguino|animals
the pet|l'animale domestico|animals
the puppy|il cucciolo|animals
the rabbit|il coniglio|animals
the rat|il ratto|animals
the rhino|il rinoceronte|animals
the sheep|la pecora|animals
the squirrel|lo scoiattolo|animals
the tiger|la tigre|animals
the whale|la balena|animals
the wolf|il lupo|animals
the zebra|la zebra|animals
the appetizer|l'antipasto|food
the avocado|l'avocado|food
the beef|la carne (di manzo)|food
the breakfast|la colazione|food
the cauliflower|il cavolfiore|food
the celery|il sedano|food
the cheese|il formaggio|food
the chicken|il pollo|food
the dessert|il dolce|food
the dinner|la cena|food
the egg|l'uovo|food
the fish (cooked)|il pesce (cotto)|food
The food|il cibo|food
the french frie|la patatina fritta|food
the hamburger|l'hamburger|food
the hotdog|l'hotdog|food
the lettuce|la lattuga|food
the lunch|il pranzo|food
the main dish|la portata principale|food
the milk|il latte|food
the pork|il maiale|food
the potato|la patata|food
the salad|l'insalata|food
the sandwich|il panino|food
the soup|la minestra|food
the sugar|lo zucchero|food
the turkey|il tacchino|food
the water|l'acqua|food
the apricot|l'albicocca|food
the banana|la banana|food
the beans|i fagioli|food
the beet|la barbabietola|food
the butter|il burro|food
the candy|la caramella|food
the flour|la farina|food
the grape|l'uva|food
the honey|il miele|food
the jam|la marmellata|food
the jelly|la gelatina (di frutta)|food
the juice|il succo|food
the ketchup|il ketchup|food
the lime|la limetta|food
the mayonnaise|la maionese|food
the mustard|la mostarda|food
the nut|la noce|food
the peach|la pesca|food
the peanut|la nocciolina|food
the peanut butter|il burro di noccioline|food
the pear|la pera|food
the pineapple|l'ananas|food
the popcorn|i popcorn|food
the radish|il ravanello|food
the raisin|l'uvetta|food
the tomato|il pomodoro|food
the lemon|il limone|food
the ankle|la caviglia|body
the arm|il braccio|body
the back|la schiena|body
the belly|la pancia|body
the brain|il cervello|body
the calf|il polpaccio|body
the chest|il petto|body
the chin|il mento|body
the ear|l'orecchio|body
the elbow|il gomito|body
the eye|l'occhio|body
the eyebrow|il sopracciglio|body
the eyelash|il ciglio|body
the eyelid|la palpebra|body
the finger|il dito|body
the fingernail|l'unghia|body
the foot|il piede|body
the forehead|la fronte|body
the mind|la mente|body
the stomach|lo stomaco|body
the gum|la gengiva|body
the hair|i capelli|body
the hand|la mano|body
the head|la testa|body
the heel|il tallone|body
the knee|il ginocchio|body
the leg|la gamba|body
the lip|il labbro|body
the mouth|la bocca|body
the nose|il naso|body
the rib|la costola|body
the teeth|i denti|body
the thigh|la coscia|body
the throat|la gola|body
the toe|il dito|body
the toenail|l'unghia (del dito del piede)|body
the tongue|la lingua|body
the wrist|il polso|body
the neck|il collo|body
the ball cap|il cappellino|clothes
the belt|la cintura|clothes
the clothes|i vestiti|clothes
the coat|il cappotto|clothes
the cotton|il cotone|clothes
the dress|il vestito|clothes
the gloves|i guanti|clothes
the hat|il cappello|clothes
the jacket|la giacca|clothes
the pajamas|il pigiama|clothes
the pants|i pantaloni|clothes
the purse|la borsa (da donna)|clothes
the sandals|i sandali|clothes
the shirt|la camicia|clothes
the shoelace|il laccio (delle scarpe)|clothes
the shoe|la scarpa|clothes
the skirt|la gonna|clothes
the socks|i calzini|clothes
the suit|il completo|clothes
the sweater|il maglione|clothes
the swimming suit|il costume (da bagno)|clothes
the tie|la cravatta|clothes
the velcro|il velcro|clothes
the zipper|la cerniera|clothes